######################################
#       # ###      ##    ###  #      #
# ### # #     ### #### #  ##  # ###  #
#   # # # ##### #       #  ## # # #  #
# ### #   ##    #######  # #  # # #  #
#   # # # #  ## #      # # #    # #  #
# ### # # # #   # #### # # # ## # #  #
#   # # # # # ###    # # # #         #
# # # # ### # # #### # # #   #########
#   # #   # # #  ^#  # # # # #       #
# # # ## ## # ## ##### # # #   ##### #
#   #     # #    #   # # # #####     #
# #########  ##### # ##  #       #####
#         ##       #    ## ####### # E
######### ################ #       # #
#         #            #     ####### #
# ######### ###### # # # #####       #
#   #   #   #      # # ### # # #######
# #   #   # # #### # #               #
######################################
